# Glossary in tab-separated format -*- coding: utf-8 -*-
Settlement	Liquidazione
Chart Wizard	Creazione guidata grafico
increase	aumentare, accrescere
check mark	segno di spunta
fine-tuning	regolazione accurata, precisa
Offline Help	Guida integrata	ultima versione della traduzione
Menu bar	barra dei menu
Extended Tips	Guida attiva	come da software
release notes	note di rilascio
Sidebar	Barra laterale
Start Center	Centro di Avvio
double-click	doppio clic
user interface	interfaccia utente
drop-down list	elenco a discesa
pinned	fissato/a/i
see	vedere
Go to	Accedere a
chevron	parentesi angolare
Single Toolbar	Barra degli strumenti singola	Menu UI
User Interface dialog	Finestra di dialogo Scegli la tua interfaccia preferita	UI
Accessibility	Accesso facilitato
sub-toolbars	barre degli strumenti secondarie
Lock Toolbars	Blocca barre degli strumenti	UI
Lock Toolbar Position	Blocca posizione della barra degli strumenti
Dock Toolbar	Aggancia barra degli strumenti	Voce UI
docked positions	posizioni di aggancio/ancoraggio
Master slide	Diapositiva schema
Zoom	Ingrandimento
Zoom slider	Cursore dello zoom
Track Changes	Revisioni	Così nell'interfaccia utente.
Style Inspector	Ispettore degli stili
decks	aree
Slide Transition	transizioni tra le diapositive
do the Sidebar	Sgancia	UI
Undock	Sgancia	UI
Dock	Aggancia	Voce UI
Wizards	Procedure guidate	Voce UI
Save All	Salva tutto	UI
Save Remote	Salva in remoto	Voce UI
AutoRecovery information every	Salva informazioni di ripristino ogni	Voce UI
Automatically save the document too	Salva automaticamente il documento	Voce UI
Print Directly	Stampa direttamente	Voce UI
System Settings	Impostazioni di sistema	Voce UI  delle versioni più recenti di MacOS
Printer Settings	Impostazioni stampante	Voce UI
Create separate print jobs for collated output	Crea ordini di stampa separati per la fascicolatura	Voce UI
Page Layout	Impaginazione	Voce UI
booklet	opuscolo
double sided	su entrambi i lati - fronte-retro
Layout Direction	Orientamento layout	Voce UI MacOs
